Айравата: змей - Айравата, змей; слон - Айравата, слон
Амогха: огонь - Амогха, огонь; якша - Амогха, якша
Бала: асура - Бала, асура; царевич - Бала, царевич
Брихадашва: мудрец - Брихадашва, мудрец; царь - Брихадашва, царь
Бхану: сын Ангираса - Бхану, сын Ангираса; сын Кришны - Бхану, сын Кришны
Бхарадваджа: мудрец - Бхарадваджа, мудрец; огонь - Бхарадваджа, огонь
Бхарата: огонь - Бхарата, огонь; сын Дашаратхи - Бхарата, сын Дашаратхи; царь - Бхарата, царь
Бхимасена: Пандава - Бхимасена, Пандава; царь - Бхимасена, царь
Вира: огонь - Вира, огонь; супруга Бхарадваджи - Вира, супруга Бхарадваджи; сын Бхарадваджи - Вира, сын Бхарадваджи
Вишвавасу: гандхарва - Вишвавасу, гандхарва; сын Джамадагни - Вишвавасу, сын Джамадагни
Ганга: лес - Ганга, лес; река - Ганга, река
Гандхамадана: гора - Гандхамадана, гора; лес - Гандхамадана, лес
Гандхари: сопровождающая Уму - Гандхари, сопровождающая Уму; супруга Дхритараштры - Гандхари, супруга Дхритараштры
Гопати: демон - Гопати, демон; огонь - Гопати, огонь
Дамана: брат Дамаянти - Дамана, брат Дамаянти; мудрец - Дамана, мудрец
Двайтавана: лес - Двайтавана, лес; озеро - Двайтавана, озеро
Индрадьюмна: брахман - Индрадьюмна, брахман; царь - Индрадьюмна, царь
Индрасена: дочь Надаяны - Индрасена, дочь Надаяны; колесничий - Индрасена, колесничий
Капила: змей - Капила, змей; корова - Капила, корова; мудрец - Капила, мудрец; огонь - Капила, огонь; река - Капила, река; тиртха - Капила, тиртха
Кешини: служанка - Кешини, служанка; сопровождающая Уму - Кешини, сопровождающая Уму
Ману: Вайвасвата - Ману, Вайвасвата; Огонь - Ману, Огонь; Сваямбхува - Ману, Сваямбхува
Медхья: лес - Медхья, лес; река - Медхья, река
Митра: божество - Митра, божество; одна из Матерей - Митра, одна из Матерей
Нала: обезьяний вожак - Нала, обезьяний вожак; сын Вирасены - Нала, сын Вирасены
Ришбха: гора - Ришабха, гора; остров - Ришабха, остров; тиртха - Ришабха, тиртха
Савитри: богиня - Савитри, богиня; царевна - Савитри, царевна
Санджая: колесничий - Санджая, колесничий; царевич - Санджая, царевич
Синдху: река - Синдху, река; страна - Синдху, страна
Субаху: царь Чеди - Субаху, царь Чеди; царь киратов - Субаху, царь киратов
Суварчас: божество - Суварчас, божество; брахман - Суварчас, брахман
Сумитра: супруга Дашаратхи - Сумитра, супруга Дашаратхи; божество - Сумитра, божество
Сушена: брат Рамы Джамадагньи - Сушена, брат Рамы Джамадагньи; свекор Валина - Сушена, свекор Валина
Хираньякашипу: асура - Хираньякашипу, асура; огонь - Хираньякашипу, огонь
Читрасена: апсара - Читрасена, апсара; гандхарва - Читрасена, гандхарва
Чьявана: мудрец - Чьявана, мудрец; огонь - Чьявана, огонь
Шива: огонь - Шива, огонь; супруга Ангираса - Шива, супруга Ангираса
Шура: царевич - Шура, царевич; царь - Шура, царь
Ямуна: гора - Ямуна, гора; река - Ямуна, река