белоконный : ['белоконный', 'белоконного', 'белоконному', 'белоконного', 'белоконным', 'белоконном']
бестелесный : ['бестелесный', 'бестелесного', 'бестелесному', 'бестелесного', 'бестелесным', 'бестелесном']
богиня : ['богиня', 'богини', 'богине', 'богиню', 'богиней', 'богине']
брахманы : ['брахманы', 'брахманов', 'брахманам', 'брахманов', 'брахманами', 'брахманах']
быкознаменный : ['быкознаменный', 'быкознамённого', 'быкознамённому', 'быкознамённого', 'быкознамённым', 'быкознамённом']
вездесущий : ['вездесущия', 'вездесущий', 'вездесущиям', 'вездесущия', 'вездесущиями', 'вездесущиях']
ветер : ['ветер', 'ветра', 'ветру', 'ветер', 'ветром', 'ветре']
владыка : ['владыка', 'владыки', 'владыке', 'владыку', 'владыкой', 'владыке']
властитель : ['властитель', 'властителя', 'властителю', 'властителя', 'властителем', 'властителе']
всевышний : ['всевышний', 'всевышнего', 'всевышнему', 'всевышнего', 'всевышним', 'всевышнем']
вседержитель : ['вседержитель', 'вседержителя', 'вседержителю', 'вседержителя', 'вседержителем', 'вседержителе']
дева : ['дева', 'девы', 'деве', 'деву', 'девой', 'деве']
дед : ['дед', 'деда', 'деду', 'деда', 'дедом', 'деде']
десятиликий : ['десятиликии', 'десятиликий', 'десятиликиям', 'десятиликий', 'десятиликиями', 'десятиликиях']
достохвальный : ['достохвальный', 'достохвального', 'достохвальному', 'достохвального', 'достохвальным', 'достохвальном']
козлоликий : ['козлоликии', 'козлоликий', 'козлоликиям', 'козлоликий', 'козлоликиями', 'козлоликиях']
лучезарный : ['лучезарный', 'лучезарного', 'лучезарному', 'лучезарного', 'лучезарным', 'лучезарном']
медовоокий : ['медовоокий', 'медовоокого', 'медовоокому', 'медовоокого', 'медовооким', 'медовооком']
неколебимый : ['неколебимый', 'неколебимого', 'неколебимому', 'неколебимого', 'неколебимым', 'неколебимом']
плугоносец : ['плугоносец', 'плугоносца', 'плугоносцу', 'плугоносца', 'плугоносцем', 'плугоносце']
победитель : ['победитель', 'победителя', 'победителю', 'победителя', 'победителем', 'победителе']
самосущий : ['самосущий', 'самосущего', 'самосущему', 'самосущего', 'самосущим', 'самосущем']
семиязыкий : ['семиязыкий', 'семиязыкого', 'семиязыкому', 'семиязыкого', 'семиязыким', 'семиязыком']
синешеий : ['синешеий', 'синешеего', 'синешеему', 'синешеего', 'синешеим', 'синешеем']
темношеий : ['темношеий', 'темношеего', 'темношеему', 'темношеего', 'темношеим', 'темношеем']
треокий : ['треокий', 'треокия', 'треокию', 'треокий', 'треокиём', 'треокие']
тысячеокий : ['тысячеокий', 'тысячеокого', 'тысячеокому', 'тысячеокого', 'тысячеоким', 'тысячеоком']
установитель : ['установитель', 'установителя', 'установителю', 'установителя', 'установителем', 'установителе']
шестиликий : ['шестиликии', 'шестиликий', 'шестиликиям', 'шестиликий', 'шестиликиями', 'шестиликиях']
заклинания : ['заклинание', 'заклинания', 'заклинанию', 'заклинание', 'заклинанием', 'заклинании']
праотцы : ['праотцы', 'праотцев', 'праотцам', 'праотцев', 'праотцами', 'праотцах']
предки : ['предки', 'предков', 'предкам', 'предков', 'предками', 'предках']
самососредоточение : ['самососредоточение', 'самососредоточения', 'самососредоточению', 'самососредоточение', 'самососредоточением', 'самососредоточении']
творец : ['творец', 'творца', 'творцу', 'творца', 'творцом', 'творце']
праотец : ['праотец', 'праотца', 'праотцу', 'праотца', 'праотцем', 'праотце']
прародитель : ['прародитель', 'прародителя', 'прародителю', 'прародителя', 'прародителем', 'прародителе']
тридцать : ['тридцать', 'тридцати', 'тридцати', 'тридцать', 'тридцатью', 'тридцати']
тридесять : ['тридесяющий', 'тридесяющего', 'тридесяющему', 'тридесяющего', 'тридесяющим', 'тридесяющем']
самосозерцание : ['самосозерцание', 'самосозерцания', 'самосозерцанию', 'самосозерцание', 'самосозерцанием', 'самосозерцании']
одиннадцатителый : ['одиннадцатителый', 'одиннадцатителого', 'одиннадцатителому', 'одиннадцатителого', 'одиннадцатителым', 'одиннадцатителом']
вкуситель жертв : ['вкуситель жертв', 'вкусителя жертв', 'вкусителю жертв', 'вкуситель жертв', 'вкусителем жертв', 'вкусителе жертв']
сын деваки : ['сын деваки', 'сына деваки', 'сыну деваки', 'сына деваки', 'сыном деваки', 'сыне деваки']
мудрецы-цари : ['мудрецы цари', 'мудрецов царей', 'мудрецам царям', 'мудрецов царей', 'мудрецами царями', 'мудрецах царях']
сын суты : ['сын суты', 'сына суты', 'сыну суты', 'сына суты', 'сыном суты', 'сыне суты']
три мира : ['три мир', 'трёх мира', 'трём миру', 'три мир', 'тремя миром', 'трёх мире']
тройственная вселенная : ['тройственная вселенная', 'тройственной вселенной', 'тройственной вселенной', 'тройственную вселенную', 'тройственной вселенной', 'тройственной вселенной']
сын сатьявати : ['сын сатьявати', 'сына сатьявати', 'сыну сатьявати', 'сына сатьявати', 'сыном сатьявати', 'сыне сатьявати']
сыновья брахмы : ['сыновья брахмы', 'сынов брахмы', 'сынам брахмы', 'сынов брахмы', 'сынами брахмы', 'сынах брахмы']
совершитель ста жертвоприношений : ['совершитель ста', 'совершителя ста', 'совершителю ста', 'совершителя ста', 'совершителем ста', 'совершителе ста']
разрушитель вражеских твердынь : ['разрушитель вражеских', 'разрушителя вражеских', 'разрушителю вражеских', 'разрушителя вражеских', 'разрушителем вражеских', 'разрушителе вражеских']
сын винаты : ['сын винаты', 'сына винаты', 'сыну винаты', 'сына винаты', 'сыном винаты', 'сыне винаты']
великий индра : ['великий индра', 'великого индра', 'великому индра', 'великого индра', 'великим индра', 'великом индра']
губитель намучи : ['губитель намучи', 'губителя намучи', 'губителю намучи', 'губителя намучи', 'губителем намучи', 'губителе намучи']
сокрушитель твердынь : ['сокрушитель твердынь', 'сокрушителя твердынь', 'сокрушителю твердынь', 'сокрушителя твердынь', 'сокрушителем твердынь', 'сокрушителе твердынь']
разрушитель твердынь : ['разрушитель твердынь', 'разрушителя твердынь', 'разрушителю твердынь', 'разрушителя твердынь', 'разрушителем твердынь', 'разрушителе твердынь']
погубитель трипуры : ['погубитель трипуры', 'погубителя трипуры', 'погубителю трипуры', 'погубителя трипуры', 'погубителем трипуры', 'погубителе трипуры']
детища брахмы : ['детище брахмы', 'детища брахмы', 'детищу брахмы', 'детище брахмы', 'детищем брахмы', 'детище брахмы']
сын шакры : ['сын шакры', 'сына шакры', 'сыну шакры', 'сына шакры', 'сыном шакры', 'сыне шакры']
творец существ : ['творец существ', 'творца существ', 'творцу существ', 'творца существ', 'творцом существ', 'творце существ']
сын вивасвана : ['сын вивасвана', 'сына вивасвана', 'сыну вивасвана', 'сына вивасвана', 'сыном вивасвана', 'сыне вивасвана']
тридцать богов : ['тридцать боги', 'тридцати богов', 'тридцати богам', 'тридцать богов', 'тридцатью богами', 'тридцати богах']
тот, кто рожден под созвездием пхальгуни : []
владетель трезубца : ['владетель трезубца', 'владетеля трезубца', 'владетелю трезубца', 'владетеля трезубца', 'владетелем трезубца', 'владетеле трезубца']
дочь яджнясены : ['дочь яджнясены', 'дочери яджнясены', 'дочери яджнясены', 'дочь яджнясены', 'дочерью яджнясены', 'дочери яджнясены']
губитель дхундху : ['губитель дхундху', 'губителя дхундху', 'губителю дхундху', 'губителя дхундху', 'губителем дхундху', 'губителе дхундху']
владыка живущих : ['владыка живущих', 'владыки живущих', 'владыке живущих', 'владыку живущих', 'владыкой живущих', 'владыке живущих']
владыка тридцати богов : ['владыка тридцати', 'владыки тридцати', 'владыке тридцати', 'владыку тридцати', 'владыкой тридцати', 'владыке тридцати']
сын рудры : ['сын рудры', 'сына рудры', 'сыну рудры', 'сына рудры', 'сыном рудры', 'сыне рудры']
властитель йоги : ['властитель йоги', 'властителя йоги', 'властителю йоги', 'властителя йоги', 'властителем йоги', 'властителе йоги']
дочь бхагиратхи : ['дочь бхагиратхи', 'дочери бхагиратхи', 'дочери бхагиратхи', 'дочь бхагиратхи', 'дочерью бхагиратхи', 'дочери бхагиратхи']
дочь друпады : ['дочь друпады', 'дочери друпады', 'дочери друпады', 'дочь друпады', 'дочерью друпады', 'дочери друпады']
увенчанный диадемой : ['увенчанный диадемой', 'увенчанного диадемой', 'увенчанному диадемой', 'увенчанного диадемой', 'увенчанным диадемой', 'увенчанном диадемой']
мать индрасены : ['мать индрасены', 'матери индрасены', 'матери индрасены', 'мать индрасены', 'матерью индрасены', 'матери индрасены']
губитель мадху : ['губитель мадху', 'губителя мадху', 'губителю мадху', 'губителя мадху', 'губителем мадху', 'губителе мадху']
властитель третьего неба : ['властитель третьего', 'властителя третьего', 'властителю третьего', 'властителя третьего', 'властителем третьего', 'властителе третьего']
сыновья дити : ['сыновья дити', 'сынов дити', 'сынам дити', 'сынов дити', 'сынами дити', 'сынах дити', 'сыновей дити']
сын васавы : ['сын васавы', 'сына васавы', 'сыну васавы', 'сына васавы', 'сыном васавы', 'сыне васавы']
губитель балы и вритры : ['губитель балы', 'губителя балы', 'губителю балы', 'губителя балы', 'губителем балы', 'губителе балы']
бог богов : ['бог богов', 'бога богов', 'богу богов', 'бога богов', 'богом богов', 'боге богов']
прародитель вселенной : ['прародитель вселенной', 'прародителя вселенной', 'прародителю вселенной', 'прародителя вселенной', 'прародителем вселенной', 'прародителе вселенной']
сын шруташравы : ['сын шруташравы', 'сына шруташравы', 'сыну шруташравы', 'сына шруташравы', 'сыном шруташравы', 'сыне шруташравы']
тот, на чьем знамени – макара : []
владыка гухьяков : ['владыка гухьяков', 'владыки гухьяков', 'владыке гухьяков', 'владыку гухьяков', 'владыкой гухьяков', 'владыке гухьяков']
царь птиц : ['царь птиц', 'царя птиц', 'царю птиц', 'царя птиц', 'царём птиц', 'царе птиц']
царь богов : ['царь богов', 'царя богов', 'царю богов', 'царя богов', 'царём богов', 'царе богов']
сын субхадры : ['сын субхадры', 'сына субхадры', 'сыну субхадры', 'сына субхадры', 'сыном субхадры', 'сыне субхадры']
сын парашары : ['сын парашары', 'сына парашары', 'сыну парашары', 'сына парашары', 'сыном парашары', 'сыне парашары']
те, что бродят в ночи : []
любовь, долг, польза : []
губитель шамбары : ['губитель шамбары', 'губителя шамбары', 'губителю шамбары', 'губителя шамбары', 'губителем шамбары', 'губителе шамбары']
царь якшей : ['царь якшей', 'царя якшей', 'царю якшей', 'царя якшей', 'царём якшей', 'царе якшей']
дочь царя панчалов : ['дочь царя', 'дочери царя', 'дочери царя', 'дочь царя', 'дочерью царя', 'дочери царя']
святые мудрецы : ['святые мудрецы', 'святых мудрецов', 'святым мудрецам', 'святых мудрецов', 'святыми мудрецами', 'святых мудрецах']
владыка богатств : ['владыка богатств', 'владыки богатств', 'владыке богатств', 'владыку богатств', 'владыкой богатств', 'владыке богатств']
несущий знак : ['несущему знак', 'несущий знак', 'несущего знак', 'несущим знак', 'несущем знак']
дочь джанаки : ['дочь джанаки', 'дочери джанаки', 'дочери джанаки', 'дочь джанаки', 'дочерью джанаки', 'дочери джанаки']
не из чрева рожденный : ['не из чрева рождённый', 'не из чрева рождённого', 'не из чрева рождённому', 'не из чрева рождённого', 'не из чрева рождённым', 'не из чрева рождённом']
даритель богатств : ['даритель богатств', 'дарителя богатств', 'дарителю богатств', 'дарителя богатств', 'дарителем богатств', 'дарителе богатств']
врата ганги : ['врата ганги', 'врат ганги', 'вратам ганги', 'врата ганги', 'вратами ганги', 'вратах ганги']
царь гандхары : ['царь гандхары', 'царя гандхары', 'царю гандхары', 'царя гандхары', 'царём гандхары', 'царе гандхары']
враг сварбхану : ['враг сварбхану', 'врага сварбхану', 'врагу сварбхану', 'врага сварбхану', 'врагом сварбхану', 'враге сварбхану']
недруг сварбхану : ['недруг сварбхану', 'недруга сварбхану', 'недругу сварбхану', 'недруга сварбхану', 'недругом сварбхану', 'недруге сварбхану']
ослепитель бхаги : ['ослепитель бхаги', 'ослепителя бхаги', 'ослепителю бхаги', 'ослепитель бхаги', 'ослепителем бхаги', 'ослепителе бхаги']
властитель ракшасов : ['властитель ракшасов', 'властителя ракшасов', 'властителю ракшасов', 'властителя ракшасов', 'властителем ракшасов', 'властителе ракшасов']
царь бессмертных : ['царь бессмертных', 'царя бессмертных', 'царю бессмертных', 'царя бессмертных', 'царём бессмертных', 'царе бессмертных']
брат гады : ['брат гады', 'брата гады', 'брату гады', 'брата гады', 'братом гады', 'брате гады']
держатель ваджры : ['держатель ваджры', 'держателя ваджры', 'держателю ваджры', 'держатель ваджры', 'держателем ваджры', 'держателе ваджры']
сын васудевы : ['сын васудевы', 'сына васудевы', 'сыну васудевы', 'сына васудевы', 'сыном васудевы', 'сыне васудевы']
царь гор : ['царь гор', 'царя гор', 'царю гор', 'царя гор', 'царём гор', 'царе гор']
сын джамбавати : ['сын джамбавати', 'сына джамбавати', 'сыну джамбавати', 'сына джамбавати', 'сыном джамбавати', 'сыне джамбавати']
сын вичитравирьи : ['сын вичитравирьи', 'сына вичитравирьи', 'сыну вичитравирьи', 'сына вичитравирьи', 'сыном вичитравирьи', 'сыне вичитравирьи']
губитель бали : ['губитель бали', 'губителя бали', 'губителю бали', 'губителя бали', 'губителем бали', 'губителе бали']
сын сумитры : ['сын сумитры', 'сына сумитры', 'сыну сумитры', 'сына сумитры', 'сыном сумитры', 'сыне сумитры']
владетель шарнги : ['владетель шарнги', 'владетеля шарнги', 'владетелю шарнги', 'владетеля шарнги', 'владетелем шарнги', 'владетеле шарнги']
потомок вришни : ['потомок вришни', 'потомка вришни', 'потомку вришни', 'потомка вришни', 'потомком вришни', 'потомке вришни']
сын шуры : ['сын шуры', 'сына шуры', 'сыну шуры', 'сына шуры', 'сыном шуры', 'сыне шуры']
владыка тысячи : ['владыка тысячи', 'владыки тысячи', 'владыке тысячи', 'владыку тысячи', 'владыкой тысячи', 'владыке тысячи']
поминальная жертва : ['поминальная жертва', 'поминальной жертвы', 'поминальной жертве', 'поминальную жертву', 'поминальной жертвой', 'поминальной жертве']
владыка вод : ['владыка вод', 'владыки вод', 'владыке вод', 'владыку вод', 'владыкой вод', 'владыке вод']
носитель капарды : ['носитель капарды', 'носителя капарды', 'носителю капарды', 'носитель капарды', 'носителем капарды', 'носителе капарды']
цари-мудрецы : ['цари мудрецы', 'царей мудрецов', 'царям мудрецам', 'царей мудрецов', 'царями мудрецами', 'царях мудрецах']
владетель гандивы : ['владетель гандивы', 'владетеля гандивы', 'владетелю гандивы', 'владетеля гандивы', 'владетелем гандивы', 'владетеле гандивы']
недруг вритры : ['недруг вритры', 'недруга вритры', 'недругу вритры', 'недруга вритры', 'недругом вритры', 'недруге вритры']
рожденный при созвездии пхальгуни : ['рождённый при', 'рождённого при', 'рождённому при', 'рождённого при', 'рождённым при', 'рождённом при']
владыка йоги : ['владыка йоги', 'владыки йоги', 'владыке йоги', 'владыку йоги', 'владыкой йоги', 'владыке йоги']
владыка трезубца : ['владыка трезубца', 'владыки трезубца', 'владыке трезубца', 'владыку трезубца', 'владыкой трезубца', 'владыке трезубца']
держатель трезубца : ['держатель трезубца', 'держателя трезубца', 'держателю трезубца', 'держатель трезубца', 'держателем трезубца', 'держателе трезубца']
великий бог : ['великий бог', 'великого бога', 'великому богу', 'великого бога', 'великим богом', 'великом боге']
сын мадри : ['сын мадри', 'сына мадри', 'сыну мадри', 'сына мадри', 'сыном мадри', 'сыне мадри']
тот, чье знамя – бык : []
сыновья мадри : ['сыновья мадри', 'сынов мадри', 'сынам мадри', 'сынов мадри', 'сынами мадри', 'сынах мадри']
властитель якшей : ['властитель якшей', 'властителя якшей', 'властителю якшей', 'властителя якшей', 'властителем якшей', 'властителе якшей']
великая смоковница : ['великая смоковница', 'великой смоковницы', 'великой смоковнице', 'великую смоковницу', 'великой смоковницей', 'великой смоковнице']
врата манасы : ['врата манасы', 'врат манасы', 'вратам манасы', 'врата манасы', 'вратами манасы', 'вратах манасы']
сокрушитель балы : ['сокрушитель балы', 'сокрушителя балы', 'сокрушителю балы', 'сокрушителя балы', 'сокрушителем балы', 'сокрушителе балы']
творец дня : ['творец дня', 'творца дня', 'творцу дня', 'творца дня', 'творцом дня', 'творце дня']
губитель недруга : ['губитель недруга', 'губителя недруга', 'губителю недруга', 'губителя недруга', 'губителем недруга', 'губителе недруга']
имеющий знаком быка : ['имеющему знаком быка', 'имеющий знаком быка', 'имеющего знаком быка', 'имеющим знаком быка', 'имеющем знаком быка']
уноситель жертв : ['уноситель жертв', 'уносителя жертв', 'уносителю жертв', 'уноситель жертв', 'уносителем жертв', 'уносителе жертв']
тот, кто владеет луков : []
польза, любовь, долг : []
губитель балы : ['губитель балы', 'губителя балы', 'губителю балы', 'губителя балы', 'губителем балы', 'губителе балы']
пасть кобылицы : ['павший кобылицы', 'павшего кобылицы', 'павшему кобылицы', 'павшего кобылицы', 'павшим кобылицы', 'павшем кобылицы']
восемь чаш : ['восемь чаши', 'восьми чаш', 'восьми чашам', 'восемь чаши', 'восемью чашами', 'восьми чашах']
вселенский бог : ['вселенский бог', 'вселенского бог', 'вселенскому бог', 'вселенского бог', 'вселенским бог', 'вселенском бог']
дева панчалы : ['дева панчалы', 'девы панчалы', 'деве панчалы', 'деву панчалы', 'девой панчалы', 'деве панчалы']
владыка богов : ['владыка богов', 'владыки богов', 'владыке богов', 'владыку богов', 'владыкой богов', 'владыке богов']
сын кунти : ['сын кунти', 'сына кунти', 'сыну кунти', 'сына кунти', 'сыном кунти', 'сыне кунти']
семь святых мудрецов : ['семь святые', 'мудрецы семи', 'святых мудрецов', 'семи святым', 'мудрецам семь', 'святых мудрецов', 'семью святыми', 'мудрецами семи', 'святых мудрецах']
великий владыка : ['великий владыка', 'великого владыки', 'великому владыке', 'великого владыку', 'великим владыкой', 'великом владыке']
тридесять богов : ['тридесяющий богов', 'тридесяющего богов', 'тридесяющему богов', 'тридесяющего богов', 'тридесяющим богов', 'тридесяющем богов']
царь растительности : ['царь растительности', 'царя растительности', 'царю растительности', 'царя растительности', 'царём растительности', 'царе растительности']
тот, чью колесницу влекут нары : []
дерево дару : ['дерево дару', 'дерева дару', 'дереву дару', 'дерево дару', 'деревом дару', 'дереве дару']
владыка рыжих коней : ['владыка рыжих', 'владыки рыжих', 'владыке рыжих', 'владыку рыжих', 'владыкой рыжих', 'владыке рыжих']
владыка существ : ['владыка существ', 'владыки существ', 'владыке существ', 'владыку существ', 'владыкой существ', 'владыке существ']
губитель данавов : ['губитель данавов', 'губителя данавов', 'губителю данавов', 'губителя данавов', 'губителем данавов', 'губителе данавов']
жертвоприношение огню : ['жертвоприношение огню', 'жертвоприношения огню', 'жертвоприношению огню', 'жертвоприношение огню', 'жертвоприношением огню', 'жертвоприношении огню']
царь нишадхов : ['царь нишадхов', 'царя нишадхов', 'царю нишадхов', 'царя нишадхов', 'царём нишадхов', 'царе нишадхов']
победитель маи : ['победитель маи', 'победителя маи', 'победителю маи', 'победителя маи', 'победителем маи', 'победителе маи']
владыка ракшасов : ['владыка ракшасов', 'владыки ракшасов', 'владыке ракшасов', 'владыку ракшасов', 'владыкой ракшасов', 'владыке ракшасов']
сын дхармы : ['сын дхармы', 'сына дхармы', 'сыну дхармы', 'сына дхармы', 'сыном дхармы', 'сыне дхармы']
внук шини : ['внук шини', 'внука шини', 'внуку шини', 'внука шини', 'внуком шини', 'внуке шини']
несущий зайца : ['несущий зайца', 'несущего зайца', 'несущему зайца', 'несущего зайца', 'несущим зайца', 'несущем зайца']
сын бхимасены : ['сын бхимасены', 'сына бхимасены', 'сыну бхимасены', 'сына бхимасены', 'сыном бхимасены', 'сыне бхимасены']
смущающий душу : ['смущающему душу', 'смущающий душу', 'смущающего душу', 'смущающим душу', 'смущающем душу']
тот, чей достойный соперник еще не родился : []
владыка тварей : ['владыка тварей', 'владыки тварей', 'владыке тварей', 'владыку тварей', 'владыкой тварей', 'владыке тварей']
губитель паки : ['губитель паки', 'губителя паки', 'губителю паки', 'губителя паки', 'губителем паки', 'губителе паки']
повелитель бхутов : ['повелитель бхутов', 'повелителя бхутов', 'повелителю бхутов', 'повелителя бхутов', 'повелителем бхутов', 'повелителе бхутов']
владыка лучей : ['владыка лучей', 'владыки лучей', 'владыке лучей', 'владыку лучей', 'владыкой лучей', 'владыке лучей']
сын джамадагни : ['сын джамадагни', 'сына джамадагни', 'сыну джамадагни', 'сына джамадагни', 'сыном джамадагни', 'сыне джамадагни']
губитель мадхусудана : ['губитель мадхусудана', 'губителя мадхусудана', 'губителю мадхусудана', 'губителя мадхусудана', 'губителем мадхусудана', 'губителе мадхусудана']
разрушитель городов : ['разрушитель городов', 'разрушителя городов', 'разрушителю городов', 'разрушителя городов', 'разрушителем городов', 'разрушителе городов']
царь видарбхов : ['царь видарбхов', 'царя видарбхов', 'царю видарбхов', 'царя видарбхов', 'царём видарбхов', 'царе видарбхов']
властитель сокровищ : ['властитель сокровищ', 'властителя сокровищ', 'властителю сокровищ', 'властителя сокровищ', 'властителем сокровищ', 'властителе сокровищ']
сын дхритараштры : ['сын дхритараштры', 'сына дхритараштры', 'сыну дхритараштры', 'сына дхритараштры', 'сыном дхритараштры', 'сыне дхритараштры']
обладатель гандивы : ['обладатель гандивы', 'обладателя гандивы', 'обладателю гандивы', 'обладателя гандивы', 'обладателем гандивы', 'обладателе гандивы']
царь звезд : ['царь звезд', 'царя звезд', 'царю звезд', 'царя звезд', 'царём звезд', 'царе звезд']
царственные мудрецы : ['царственные мудрецы', 'царственных мудрецы', 'царственным мудрецы', 'царственных мудрецы', 'царственными мудрецы', 'царственных мудрецы']
гора восхода : ['гора восхода', 'горы восхода', 'горе восхода', 'гору восхода', 'горой восхода', 'горе восхода']
губитель сварбхану : ['губитель сварбхану', 'губителя сварбхану', 'губителю сварбхану', 'губителя сварбхану', 'губителем сварбхану', 'губителе сварбхану']
сын вирочаны : ['сын вирочаны', 'сына вирочаны', 'сыну вирочаны', 'сына вирочаны', 'сыном вирочаны', 'сыне вирочаны']
владыка нишадхов : ['владыка нишадхов', 'владыки нишадхов', 'владыке нишадхов', 'владыку нишадхов', 'владыкой нишадхов', 'владыке нишадхов']
веда гандхарвов : ['веда гандхарвов', 'веды гандхарвов', 'веде гандхарвов', 'веду гандхарвов', 'ведой гандхарвов', 'веде гандхарвов']
сын даруки : ['сын даруки', 'сына даруки', 'сыну даруки', 'сына даруки', 'сыном даруки', 'сыне даруки']
сын гандхари : ['сын гандхари', 'сына гандхари', 'сыну гандхари', 'сына гандхари', 'сыном гандхари', 'сыне гандхари']
шествующий по небу : ['шествующему по небу', 'шествующий по небу', 'шествующего по небу', 'шествующим по небу', 'шествующем по небу']
разрушитель вражеских городов : ['разрушитель вражеских', 'разрушителя вражеских', 'разрушителю вражеских', 'разрушителя вражеских', 'разрушителем вражеских', 'разрушителе вражеских']
владыка дашархов : ['владыка дашархов', 'владыки дашархов', 'владыке дашархов', 'владыку дашархов', 'владыкой дашархов', 'владыке дашархов']
обхождение слева направо : ['обхождение слева', 'обхождения слева', 'обхождению слева', 'обхождение слева', 'обхождением слева', 'обхождении слева']
тот, кто владеет шарнгой : []
сокрушитель городов : ['сокрушитель городов', 'сокрушителя городов', 'сокрушителю городов', 'сокрушителя городов', 'сокрушителем городов', 'сокрушителе городов']
царь дхармы : ['царь дхармы', 'царя дхармы', 'царю дхармы', 'царя дхармы', 'царём дхармы', 'царе дхармы']
владетель раковины, диска и палицы : ['владетель раковины,', 'владетеля раковины,', 'владетелю раковины,', 'владетеля раковины,', 'владетелем раковины,', 'владетеле раковины,']
тот, чей соперник еще не родился : []
сын притхи : ['сын притхи', 'сына притхи', 'сыну притхи', 'сына притхи', 'сыном притхи', 'сыне притхи']
пожиратель жертв : ['пожиратель жертв', 'пожирателя жертв', 'пожирателю жертв', 'пожирателя жертв', 'пожирателем жертв', 'пожирателе жертв']
сын бхангасвары : ['сын бхангасвары', 'сына бхангасвары', 'сыну бхангасвары', 'сына бхангасвары', 'сыном бхангасвары', 'сыне бхангасвары']
царь панчалы : ['царь панчалы', 'царя панчалы', 'царю панчалы', 'царя панчалы', 'царём панчалы', 'царе панчалы']
пять великих элементов : ['пять великие', 'элементы пяти', 'великих элементов', 'пяти великим', 'элементам пять', 'великие элементы', 'пятью великими', 'элементами пяти', 'великих элементах']
владыка ваджры : ['владыка ваджры', 'владыки ваджры', 'владыке ваджры', 'владыку ваджры', 'владыкой ваджры', 'владыке ваджры']
сын готамы : ['сын готамы', 'сына готамы', 'сыну готамы', 'сына готамы', 'сыном готамы', 'сыне готамы']
супруг шачи : ['супруг шачи', 'супруга шачи', 'супругу шачи', 'супруга шачи', 'супругом шачи', 'супруге шачи']
мудрецы-брахманы : ['мудрецы брахманы', 'мудрецов брахманов', 'мудрецам брахманам', 'мудрецов брахманов', 'мудрецами брахманами', 'мудрецах брахманах']
сын панду : ['сын панду', 'сына панду', 'сыну панду', 'сына панду', 'сыном панду', 'сыне панду']
сын амбики : ['сын амбики', 'сына амбики', 'сыну амбики', 'сына амбики', 'сыном амбики', 'сыне амбики']
творец миров : ['творец миров', 'творца миров', 'творцу миров', 'творца миров', 'творцом миров', 'творце миров']
голова брахмы : ['голова брахмы', 'головы брахмы', 'голове брахмы', 'голову брахмы', 'головой брахмы', 'голове брахмы']
владыка гандивы : ['владыка гандивы', 'владыки гандивы', 'владыке гандивы', 'владыку гандивы', 'владыкой гандивы', 'владыке гандивы']
владыка якшей : ['владыка якшей', 'владыки якшей', 'владыке якшей', 'владыку якшей', 'владыкой якшей', 'владыке якшей']
сыновья калаки : ['сыновья калаки', 'сынов калаки', 'сынам калаки', 'сынов калаки', 'сынами калаки', 'сынах калаки', 'сыновей калаки']
владыка сокровищ : ['владыка сокровищ', 'владыки сокровищ', 'владыке сокровищ', 'владыку сокровищ', 'владыкой сокровищ', 'владыке сокровищ']
божественные мудрецы : ['божественные мудрецы', 'божественных мудрецов', 'божественным мудрецам', 'божественных мудрецов', 'божественными мудрецами', 'божественных мудрецах']
дочь бхимы : ['дочь бхимы', 'дочери бхимы', 'дочери бхимы', 'дочь бхимы', 'дочерью бхимы', 'дочери бхимы']
владетель лука : ['владетель лука', 'владетеля лука', 'владетелю лука', 'владетеля лука', 'владетелем лука', 'владетеле лука']
сын хидимбы : ['сын хидимбы', 'сына хидимбы', 'сыну хидимбы', 'сына хидимбы', 'сыном хидимбы', 'сыне хидимбы']
равно владеющий и правой, и левой рукой : ['равно владеющему и правой, и левой рукой', 'равно владеющий и правой, и левой рукой', 'равно владеющего и правой, и левой рукой', 'равно владеющим и правой, и левой рукой', 'равно владеющем и правой, и левой рукой']
сын радхи : ['сын радхи', 'сына радхи', 'сыну радхи', 'сына радхи', 'сыном радхи', 'сыне радхи']
демоны-змеи : ['демоны змея', 'демонов змеи', 'демонам змее', 'демонов змею', 'демонами змеёй', 'демонах змее']
губитель вритры : ['губитель вритры', 'губителя вритры', 'губителю вритры', 'губителя вритры', 'губителем вритры', 'губителе вритры']
владыка бхутов : ['владыка бхутов', 'владыки бхутов', 'владыке бхутов', 'владыку бхутов', 'владыкой бхутов', 'владыке бхутов']
повелитель богов : ['повелитель богов', 'повелителя богов', 'повелителю богов', 'повелителя богов', 'повелителем богов', 'повелителе богов']
сын вирасены : ['сын вирасены', 'сына вирасены', 'сыну вирасены', 'сына вирасены', 'сыном вирасены', 'сыне вирасены']
южный синдху : ['южный синдху', 'южного синдху', 'южному синдху', 'южного синдху', 'южным синдху', 'южном синдху']
сын дроны : ['сын дроны', 'сына дроны', 'сыну дроны', 'сына дроны', 'сыном дроны', 'сыне дроны']
даритель сокровищ : ['даритель сокровищ', 'дарителя сокровищ', 'дарителю сокровищ', 'дарителя сокровищ', 'дарителем сокровищ', 'дарителе сокровищ']
сокрушитель мадху : ['сокрушитель мадху', 'сокрушителя мадху', 'сокрушителю мадху', 'сокрушителя мадху', 'сокрушителем мадху', 'сокрушителе мадху']
владыка сущего : ['владыка сущего', 'владыки сущего', 'владыке сущего', 'владыку сущего', 'владыкой сущего', 'владыке сущего']
носитель знака шриватсы : ['носитель знака', 'носителя знака', 'носителю знака', 'носитель знака', 'носителем знака', 'носителе знака']
мать сутасомы : ['мать сутасомы', 'матери сутасомы', 'матери сутасомы', 'мать сутасомы', 'матерью сутасомы', 'матери сутасомы']
дочь химавана : ['дочь химавана', 'дочери химавана', 'дочери химавана', 'дочь химавана', 'дочерью химавана', 'дочери химавана']
сокрушитель мадхусудана : ['сокрушитель мадхусудана', 'сокрушителя мадхусудана', 'сокрушителю мадхусудана', 'сокрушителя мадхусудана', 'сокрушителем мадхусудана', 'сокрушителе мадхусудана']
сын рукмини : ['сын рукмини', 'сына рукмини', 'сыну рукмини', 'сына рукмини', 'сыном рукмини', 'сыне рукмини']
тридцать три бога : ['тридцать три', 'бог тридцати', 'трёх бога', 'тридцати трём', 'богу тридцать', 'три бога', 'тридцатью тремя', 'богом тридцати', 'трёх боге']
владыка марутов : ['владыка марутов', 'владыки марутов', 'владыке марутов', 'владыку марутов', 'владыкой марутов', 'владыке марутов']
владыка тысячи лучей : ['владыка тысячи', 'владыки тысячи', 'владыке тысячи', 'владыку тысячи', 'владыкой тысячи', 'владыке тысячи']
брахманы-мудрецы : ['брахманы мудрецы', 'брахманов мудрецов', 'брахманам мудрецам', 'брахманов мудрецов', 'брахманами мудрецами', 'брахманах мудрецах']
сын хридики : ['сын хридики', 'сына хридики', 'сыну хридики', 'сына хридики', 'сыном хридики', 'сыне хридики']
обладатель пинаки : ['обладатель пинаки', 'обладателя пинаки', 'обладателю пинаки', 'обладателя пинаки', 'обладателем пинаки', 'обладателе пинаки']
сын индрадьюмны : ['сын индрадьюмны', 'сына индрадьюмны', 'сыну индрадьюмны', 'сына индрадьюмны', 'сыном индрадьюмны', 'сыне индрадьюмны']
прародитель мира : ['прародитель мира', 'прародителя мира', 'прародителю мира', 'прародителя мира', 'прародителем мира', 'прародителе мира']
сын шантану : ['сын шантану', 'сына шантану', 'сыну шантану', 'сына шантану', 'сыном шантану', 'сыне шантану']
сокрушитель вражеских твердынь : ['сокрушитель вражеских', 'сокрушителя вражеских', 'сокрушителю вражеских', 'сокрушителя вражеских', 'сокрушителем вражеских', 'сокрушителе вражеских']
сын паршаты : ['сын паршаты', 'сына паршаты', 'сыну паршаты', 'сына паршаты', 'сыном паршаты', 'сыне паршаты']
владыка тридесяти богов : ['владыка тридесяти', 'владыки тридесяти', 'владыке тридесяти', 'владыку тридесяти', 'владыкой тридесяти', 'владыке тридесяти']
сын ветра : ['сын ветра', 'сына ветра', 'сыну ветра', 'сына ветра', 'сыном ветра', 'сыне ветра']
потомки калаки : ['потомки калаки', 'потомков калаки', 'потомкам калаки', 'потомков калаки', 'потомками калаки', 'потомках калаки']
сын субалы : ['сын субалы', 'сына субалы', 'сыну субалы', 'сына субалы', 'сыном субалы', 'сыне субалы']
хранители мира : ['хранители мира', 'хранителей мира', 'хранителям мира', 'хранителей мира', 'хранителями мира', 'хранителях мира']
завоеватель богатств : ['завоеватель богатств', 'завоевателя богатств', 'завоевателю богатств', 'завоевателя богатств', 'завоевателем богатств', 'завоевателе богатств']
царь царей : ['царь царей', 'царя царей', 'царю царей', 'царя царей', 'царём царей', 'царе царей']
держатель копья : ['держатель копья', 'держателя копья', 'держателю копья', 'держатель копья', 'держателем копья', 'держателе копья']
супруг умы : ['супруг умы', 'супруга умы', 'супругу умы', 'супруга умы', 'супругом умы', 'супруге умы']
мудрецы-боги : ['мудрецы боги', 'мудрецов богов', 'мудрецам богам', 'мудрецов богов', 'мудрецами богами', 'мудрецах богах']
сын шишупалы : ['сын шишупалы', 'сына шишупалы', 'сыну шишупалы', 'сына шишупалы', 'сыном шишупалы', 'сыне шишупалы']
праотец человечества : ['праотец человечества', 'праотца человечества', 'праотцу человечества', 'праотца человечества', 'праотцем человечества', 'праотце человечества']
царь справедливости : ['царь справедливости', 'царя справедливости', 'царю справедливости', 'царя справедливости', 'царём справедливости', 'царе справедливости']
владыка тридцати : ['владыка тридцати', 'владыки тридцати', 'владыке тридцати', 'владыку тридцати', 'владыкой тридцати', 'владыке тридцати']
властелин бхутов : ['властелин бхутов', 'властелина бхутов', 'властелину бхутов', 'властелина бхутов', 'властелином бхутов', 'властелине бхутов']
жертвоприношение коня : ['жертвоприношение коня', 'жертвоприношения коня', 'жертвоприношению коня', 'жертвоприношение коня', 'жертвоприношением коня', 'жертвоприношении коня']
сокрушитель вражеских городов : ['сокрушитель вражеских', 'сокрушителя вражеских', 'сокрушителю вражеских', 'сокрушителя вражеских', 'сокрушителем вражеских', 'сокрушителе вражеских']
владыка пинаки : ['владыка пинаки', 'владыки пинаки', 'владыке пинаки', 'владыку пинаки', 'владыкой пинаки', 'владыке пинаки']
творец вселенной : ['творец вселенной', 'творца вселенной', 'творцу вселенной', 'творца вселенной', 'творцом вселенной', 'творце вселенной']
сыновья пуломы : ['сыновья пуломы', 'сынов пуломы', 'сынам пуломы', 'сынов пуломы', 'сынами пуломы', 'сынах пуломы']
властитель богатств : ['властитель богатств', 'властителя богатств', 'властителю богатств', 'властителя богатств', 'властителем богатств', 'властителе богатств']
владетель пинаки : ['владетель пинаки', 'владетеля пинаки', 'владетелю пинаки', 'владетеля пинаки', 'владетелем пинаки', 'владетеле пинаки']
властитель звезд : ['властитель звезд', 'властителя звезд', 'властителю звезд', 'властителя звезд', 'властителем звезд', 'властителе звезд']
сокрушитель трипуры : ['сокрушитель трипуры', 'сокрушителя трипуры', 'сокрушителю трипуры', 'сокрушителя трипуры', 'сокрушителем трипуры', 'сокрушителе трипуры']
превеликая бадари : ['превеликая бадари', 'превеликой бадари', 'превеликой бадари', 'превеликую бадари', 'превеликой бадари', 'превеликой бадари']
дощечки для добывания огня : ['дощечка для', 'дощечки для', 'дощечке для', 'дощечку для', 'дощечкой для', 'дощечке для']
сын возницы : ['сын возницы', 'сына возницы', 'сыну возницы', 'сына возницы', 'сыном возницы', 'сыне возницы']
обуянные яростью : ['обуянные яростью', 'обуянных яростью', 'обуянным яростью', 'обуянных яростью', 'обуянными яростью', 'обуянных яростью']
владыка третьего неба : ['владыка третьего', 'владыки третьего', 'владыке третьего', 'владыку третьего', 'владыкой третьего', 'владыке третьего']
разрушитель трипуры : ['разрушитель трипуры', 'разрушителя трипуры', 'разрушителю трипуры', 'разрушителя трипуры', 'разрушителем трипуры', 'разрушителе трипуры']
каратель паки : ['каратель паки', 'карателя паки', 'карателю паки', 'карателя паки', 'карателем паки', 'карателе паки']
царь правосудия : ['царь правосудия', 'царя правосудия', 'царю правосудия', 'царя правосудия', 'царём правосудия', 'царе правосудия']
город слона : ['город слона', 'города слона', 'городу слона', 'город слона', 'городом слона', 'городе слона']
великий полководец : ['великий полководец', 'великого полководца', 'великому полководцу', 'великого полководца', 'великим полководцем', 'великом полководце']
тот, чье оружие – плуг : []
любовь, польза, долг : []
владетель ваджры : ['владетель ваджры', 'владетеля ваджры', 'владетелю ваджры', 'владетеля ваджры', 'владетелем ваджры', 'владетеле ваджры']
долг, польза, любовь : ['любовь любви', 'любви любовь', 'любовью любви']
польза, долг, любовь : []
владыка трех миров : ['владыка трех', 'владыки трех', 'владыке трех', 'владыку трех', 'владыкой трех', 'владыке трех']
сын огня : ['сын огня', 'сына огня', 'сыну огня', 'сына огня', 'сыном огня', 'сыне огня']
старший брат гады : ['старший брат гады', 'старшего брата гады', 'старшему брату гады', 'старшего брата гады', 'старшим братом гады', 'старшем брате гады']
третье небо : ['третье небо', 'третьего неба', 'третьему небу', 'третье небо', 'третьим небом', 'третьем небе']
долг, любовь, польза : []
сын джанарданы : ['сын джанарданы', 'сына джанарданы', 'сыну джанарданы', 'сына джанарданы', 'сыном джанарданы', 'сыне джанарданы']
сын индры : ['сын индры', 'сына индры', 'сыну индры', 'сына индры', 'сыном индры', 'сыне индры']
вселенский владыка : ['вселенский владыка', 'вселенского владыки', 'вселенскому владыке', 'вселенского владыку', 'вселенским владыкой', 'вселенском владыке']
